##########
#  #  #  #
#  #  #  #
# ## ## ##
:        :
## ## ## #
#   #  # #
#   #  # #
#   #  # #
##########
